a O.....
b O.O...
c OO....
d OO.O..
e O..O..
f OOO...
g OOOO..
h O.OO..
i .OO...
j .OOO..
k O...O.
l O.O.O.
m OO..O.
n OO.OO.
o O..OO.
p OOO.O.
q OOOOO.
r O.OOO.
s .OO.O.
t .OOOO.
u O...OO
v O.O.OO
w .OOO.O
x OO..OO
y OO.OOO
z O..OOO
capital .....O
number .O.OOO
space ......